
//Palette Count 16
0x15,0x00,0x3F,0x01,0x02,0x03,0x0B,0x0F,
0x2A,0x2B,0x06,0x1D,0x19,0x04,0x3D,0x20,
//Block Count=160

0x00,0xFF,0xFF,0xFF,0x00,0xFF,0xFF,0xFF,0x00,0xFF,0xFF,0xFF,0x00,0xFF,0xFF,0xFF,
0x00,0xFF,0xFF,0xFF,0x00,0xFF,0xFF,0xFF,0x00,0xFF,0xFF,0xFF,0x00,0xFF,0xFF,0xFF,
0xFF,0x00,0x00,0x00,0xFF,0x3F,0x00,0x00,0xE0,0x5F,0x00,0x1F,0xF0,0x6F,0x00,0x0F,
0xD8,0x77,0x00,0x27,0xCC,0x7B,0x00,0x33,0xC6,0x7D,0x00,0x39,0xC3,0x7E,0x00,0x3C,
0xFF,0x00,0x00,0x00,0xFF,0xFD,0x00,0x00,0x05,0xFB,0x0A,0xF0,0x0D,0xF7,0x12,0xE0,
0x19,0xEF,0x22,0xC4,0x31,0xDF,0x42,0x8C,0x61,0xBF,0x82,0x1C,0xC1,0x7F,0x02,0x3C,
0xC1,0x7E,0x02,0x3C,0xC3,0x7D,0x04,0x38,0xC6,0x7B,0x08,0x31,0xCC,0x77,0x10,0x23,
0xD8,0x6F,0x20,0x07,0xF0,0x5F,0x00,0x0F,0xC0,0x3F,0x3F,0x00,0xFF,0x7F,0x00,0x00,
0x81,0x7F,0x02,0x7C,0xC1,0xBF,0x02,0x3C,0x61,0xDF,0x02,0x9C,0x31,0xEF,0x02,0xCC,
0x19,0xF7,0x02,0xE4,0x0D,0xFB,0x02,0xF0,0x03,0xFD,0xFC,0x00,0xFF,0xFE,0x00,0x00,
0x3C,0x3C,0x00,0x3C,0x7E,0x7E,0x00,0x7E,0x5A,0x7E,0x00,0x5A,0x7E,0x5A,0x00,0x5A,
0x7E,0x7E,0x00,0x7E,0x24,0x24,0x00,0x24,0x24,0x24,0x00,0x24,0x42,0x42,0x00,0x42,
0x3C,0x3C,0x00,0x3C,0x7E,0x7E,0x00,0x7E,0x7E,0x5A,0x00,0x5A,0x5A,0x7E,0x00,0x5A,
0x7E,0x7E,0x00,0x7E,0x24,0x24,0x00,0x24,0x18,0x18,0x00,0x18,0x18,0x18,0x00,0x18,
0x00,0x00,0x3C,0x00,0x00,0x00,0x7E,0x00,0x00,0x24,0x5A,0x00,0x24,0x00,0x5A,0x00,
0x81,0x81,0x7E,0x00,0x99,0x99,0x00,0x00,0x81,0x81,0x00,0x00,0x81,0x81,0x00,0x00,
0x81,0x81,0x3C,0x00,0x81,0x81,0x7E,0x00,0xA5,0x81,0x5A,0x00,0x81,0xA5,0x5A,0x00,
0x81,0x81,0x7E,0x00,0x24,0x24,0x00,0x00,0x00,0x00,0x00,0x00,0x00,0x00,0x00,0x00,
0x00,0x18,0x18,0x18,0x00,0x18,0x00,0x00,0x00,0x00,0x00,0x18,0x00,0x3C,0x3C,0x3C,
0x00,0x7E,0x7E,0x7E,0x00,0x7E,0x5A,0x5A,0x24,0x5A,0x5A,0x5A,0x00,0x7E,0x7E,0x7E,
0x00,0x7E,0x7E,0x7E,0x00,0x18,0x00,0x00,0x00,0x00,0x00,0x18,0x00,0x3C,0x3C,0x3C,
0x00,0x7E,0x7E,0x7E,0x24,0x5A,0x5A,0x5A,0x00,0x7E,0x5A,0x5A,0x00,0x7E,0x7E,0x7E,
0x00,0x00,0x00,0x00,0x00,0x00,0x00,0x18,0x00,0x00,0x00,0x18,0x00,0x00,0x00,0x18,
0x18,0x00,0x00,0x24,0x3C,0x00,0x00,0x42,0x00,0x00,0x00,0xFF,0x00,0x00,0x00,0xBD,
0x00,0x00,0x00,0x00,0x00,0x18,0x18,0x18,0x00,0x18,0x18,0x18,0x00,0x18,0x18,0x18,
0x00,0x00,0x00,0x00,0x00,0x00,0x00,0x00,0x00,0x00,0x00,0x00,0x00,0x00,0x00,0x00,
0x00,0x00,0x00,0x7E,0x00,0x7E,0x00,0x81,0x7E,0x00,0x00,0x81,0x00,0x00,0x00,0x7E,
0x00,0x00,0x00,0x00,0x00,0x00,0x00,0x00,0x00,0x00,0x00,0x00,0x00,0x00,0x00,0x00,
0x00,0x00,0x00,0x00,0x00,0x00,0x00,0x00,0x00,0x00,0x00,0x00,0x00,0x00,0x00,0x00,
0x00,0x00,0x00,0x00,0x00,0x00,0x00,0x00,0x00,0x18,0x00,0x00,0x00,0x18,0x00,0x00,
0xFF,0xFF,0x00,0x00,0x80,0x80,0x7F,0x00,0x80,0x80,0x7F,0x00,0x80,0x80,0x7F,0x00,
0x80,0x80,0x7F,0x00,0x80,0x80,0x7F,0x00,0x80,0x80,0x7F,0x00,0x80,0x80,0x7F,0x00,
0x00,0x00,0x00,0x00,0x00,0x00,0x00,0x00,0x34,0x30,0x04,0x00,0x7E,0x7C,0x02,0x00,
0x7E,0x7E,0x00,0x00,0x3C,0x3C,0x00,0x00,0x18,0x18,0x00,0x00,0x00,0x00,0x00,0x00,
0x00,0x00,0x00,0x00,0x00,0x00,0x00,0x00,0x00,0x00,0x00,0x00,0x00,0x00,0x00,0x00,
0x00,0x00,0x00,0x00,0x00,0x00,0x00,0x00,0x00,0x00,0x00,0x00,0x00,0x00,0x00,0x00,
0x00,0x00,0x00,0x00,0x00,0x00,0x00,0x00,0x00,0x00,0x00,0x00,0x00,0x00,0x00,0x00,
0x00,0x00,0x00,0x00,0x00,0x00,0x00,0x00,0x00,0x00,0x00,0x00,0x00,0x00,0x00,0x00,
0x00,0x00,0x00,0x00,0x00,0x00,0x00,0x00,0x00,0x00,0x00,0x00,0x00,0x00,0x00,0x00,
0x00,0x00,0x00,0x00,0x00,0x00,0x00,0x00,0x00,0x00,0x00,0x00,0x00,0x00,0x00,0x00,
0x00,0x6C,0x00,0x00,0x28,0xD6,0x00,0x00,0x29,0xD6,0x00,0x00,0x28,0xD7,0x01,0x01,
0x00,0xFF,0x01,0x01,0x00,0x7F,0x13,0x13,0x70,0x0F,0x0F,0x0F,0xF8,0x07,0x07,0x77,
0x00,0x00,0x00,0x00,0x70,0x00,0x00,0x00,0x98,0x00,0x70,0x00,0x6C,0x80,0x98,0x80,
0x14,0xE0,0xE8,0xE0,0x0C,0xF0,0xF0,0xF0,0x0B,0xF0,0xF0,0xF0,0x05,0x80,0xFA,0x80,
0xFC,0x03,0x03,0x7B,0xFE,0x01,0x01,0x4D,0x7F,0x00,0x00,0x3E,0x3E,0x00,0x01,0x1D,
0x1C,0x00,0x03,0x03,0x0C,0x00,0x03,0x03,0x03,0x00,0x00,0x00,0x00,0x00,0x00,0x00,
0x77,0x00,0x8A,0x70,0xC5,0x00,0x3A,0xC8,0x07,0x00,0xF8,0xF8,0x04,0x00,0xF8,0xF8,
0x08,0x00,0xF0,0xF0,0x1C,0x00,0xE0,0xE8,0xF8,0x00,0x00,0x10,0x10,0x00,0x00,0x00,
0x00,0x04,0x68,0x68,0x00,0x02,0xFC,0xFC,0x01,0x00,0xFE,0xFE,0x28,0xD7,0x01,0x01,
0x28,0xD7,0x01,0x01,0x00,0x7F,0x13,0x13,0x70,0x0F,0x0F,0x0F,0xF8,0x07,0x07,0x77,
0x00,0x00,0x00,0x00,0x70,0x00,0x00,0x00,0x98,0x00,0x70,0x00,0x6C,0x80,0x98,0x80,
0x14,0xE0,0xE8,0xE0,0x0C,0x90,0xF0,0x90,0x68,0x00,0x90,0x60,0x67,0x08,0x98,0x68,
0xB4,0x7B,0x03,0x03,0xFE,0x79,0x01,0x05,0x7F,0x3C,0x00,0x02,0x56,0x38,0x01,0x05,
0x3C,0x00,0x03,0x1B,0x18,0x00,0x07,0x07,0x07,0x00,0x00,0x00,0x00,0x00,0x00,0x00,
0x47,0x1A,0xB8,0x58,0x05,0x00,0xFA,0xF8,0x07,0x02,0xF8,0xF8,0x07,0x00,0xF8,0xF8,
0x08,0x00,0xF0,0xF0,0x1C,0x00,0xE0,0xE8,0xF8,0x00,0x00,0x10,0x10,0x00,0x00,0x00,
0x07,0x07,0x07,0x07,0x19,0x1E,0x1B,0x1B,0x20,0x3E,0x23,0x23,0x43,0x7F,0x44,0x47,
0x46,0x7F,0x79,0x7F,0xDC,0x1F,0x62,0x7E,0xCC,0x3F,0x72,0x7E,0x84,0x7F,0x4A,0x4E,
0xE0,0xE0,0xE0,0xE0,0xF8,0x18,0xF8,0xF8,0x04,0x1C,0xF4,0xF4,0xE2,0xEE,0x1A,0xFA,
0x12,0xF6,0xEE,0xFE,0x0B,0xF9,0x17,0x1F,0x0B,0xF9,0x17,0x1F,0x09,0xFB,0x17,0x1F,
0x80,0x79,0x4F,0x4F,0xCF,0x30,0x7F,0x7F,0xFF,0x0F,0x70,0x70,0x7A,0x35,0x00,0x08,
0x3B,0x04,0x00,0x19,0x3F,0x00,0x00,0x1F,0x1F,0x00,0x01,0x0E,0x0F,0x00,0x00,0x00,
0x01,0xE7,0xFD,0xFD,0xF9,0x07,0xFD,0xFD,0xFD,0xF3,0x0F,0x0F,0x5E,0xAE,0x02,0x12,
0xDC,0x20,0x00,0x98,0xFC,0x00,0x10,0xE8,0xF8,0x00,0xE0,0x10,0xF0,0x00,0x00,0x00,
0x00,0x00,0x00,0x00,0x66,0x66,0x00,0x00,0xFF,0xFD,0x02,0x00,0xFF,0xFE,0x01,0x00,
0xFF,0xFF,0x00,0x00,0x7E,0x7E,0x00,0x00,0x3C,0x3C,0x00,0x00,0x18,0x18,0x00,0x00,
0x00,0x00,0x00,0x00,0x03,0x00,0x00,0x00,0x0E,0x01,0x00,0x00,0x3C,0x02,0x00,0x00,
0x7D,0x00,0x08,0x00,0x6F,0x00,0x18,0x00,0xAF,0x00,0x58,0x00,0x8F,0x00,0x78,0x00,
0x00,0x00,0x00,0x00,0xF3,0x00,0x00,0x00,0x0C,0xF3,0x00,0x00,0x08,0x04,0x00,0x00,
0xFB,0x00,0x00,0x00,0xFF,0x00,0x00,0x00,0xFF,0x00,0x00,0x00,0x9F,0x60,0x00,0x00,
0xFF,0x00,0x30,0x00,0xFC,0x03,0x00,0x00,0x78,0x07,0x00,0x00,0x78,0x00,0x00,0x07,
0x3C,0x00,0x00,0x00,0x0F,0x00,0x00,0x00,0x03,0x00,0x00,0x00,0x00,0x00,0x00,0x00,
0x8F,0x60,0x00,0x10,0x8F,0x40,0x00,0x30,0x0F,0x80,0x00,0x60,0x1F,0x00,0x00,0x80,
0x7F,0x00,0x00,0x00,0xFF,0x00,0x00,0x00,0xF3,0x00,0x00,0x00,0x00,0x00,0x00,0x00,
0x01,0x01,0x00,0x00,0x03,0x03,0x01,0x00,0x03,0x03,0x01,0x00,0x07,0x07,0x03,0x00,
0x07,0x07,0x03,0x00,0xFD,0xFF,0x05,0x00,0xFA,0xFD,0x78,0x00,0x7A,0x7D,0x38,0x00,
0x80,0x80,0x00,0x00,0x40,0xC0,0x00,0x00,0x40,0xC0,0x00,0x00,0xA0,0xE0,0x80,0x00,
0xE0,0xE0,0xC0,0x00,0xBF,0xFF,0xA0,0x00,0x5F,0xBF,0x1E,0x00,0x5E,0xBE,0x1C,0x00,
0x3A,0x3D,0x18,0x00,0x1F,0x1F,0x0F,0x00,0x1F,0x1B,0x0B,0x00,0x3F,0x3C,0x1C,0x00,
0x3F,0x3F,0x1E,0x00,0x7E,0x7E,0x3C,0x00,0x7C,0x7C,0x30,0x00,0x70,0x70,0x00,0x00,
0x5C,0xBC,0x18,0x00,0xF8,0xF8,0xF0,0x00,0xF8,0xD8,0xD0,0x00,0xFC,0x3C,0x38,0x00,
0xFC,0xFC,0x78,0x00,0x7E,0x7E,0x3C,0x00,0x3E,0x3E,0x0C,0x00,0x0E,0x0E,0x00,0x00,
0x01,0x01,0x00,0x00,0x03,0x03,0x01,0x00,0x03,0x03,0x01,0x00,0x07,0x07,0x03,0x00,
0x07,0x07,0x03,0x00,0x0F,0x0F,0x07,0x00,0x0E,0x0F,0x06,0x00,0x0F,0x0F,0x07,0x00,
0x80,0x80,0x00,0x00,0x40,0xC0,0x00,0x00,0x40,0xC0,0x00,0x00,0xA0,0xE0,0x80,0x00,
0xE0,0xE0,0xC0,0x00,0xF0,0xF0,0xE0,0x00,0x70,0xF0,0x60,0x00,0xF0,0xF0,0xE0,0x00,
0x07,0x07,0x03,0x00,0x07,0x07,0x03,0x00,0x07,0x07,0x03,0x00,0x07,0x07,0x03,0x00,
0x03,0x03,0x01,0x00,0x03,0x03,0x01,0x00,0x03,0x03,0x01,0x00,0x01,0x01,0x00,0x00,
0xE0,0xE0,0xC0,0x00,0xE0,0xE0,0xC0,0x00,0xE0,0xE0,0xC0,0x00,0xE0,0xE0,0xC0,0x00,
0xC0,0xC0,0x80,0x00,0xC0,0xC0,0x80,0x00,0xC0,0xC0,0x80,0x00,0x80,0x80,0x00,0x00,
0x00,0x00,0x00,0x00,0x1C,0x00,0x00,0x00,0x3E,0x1C,0x1C,0x00,0x73,0x3E,0x3A,0x00,
0x6B,0x3E,0x3E,0x00,0x77,0x3E,0x3E,0x00,0x3E,0x1C,0x1C,0x00,0x1C,0x00,0x00,0x00,
0x00,0x00,0x00,0x00,0x18,0x00,0x00,0x00,0x24,0x18,0x18,0x00,0x3C,0x18,0x18,0x00,
0x24,0x18,0x00,0x00,0x3C,0x18,0x18,0x00,0x24,0x18,0x18,0x00,0x18,0x00,0x00,0x00,
0x00,0x00,0x00,0x00,0x00,0x00,0x00,0x00,0x00,0x00,0x00,0x00,0x00,0x00,0x00,0x00,
0x00,0x00,0x00,0x00,0x00,0x00,0x00,0x00,0x00,0x00,0x00,0x00,0x00,0x00,0x00,0x00,
0x00,0x00,0x00,0x00,0x00,0x00,0x00,0x00,0x00,0x00,0x00,0x00,0x00,0x00,0x00,0x00,
0x00,0x00,0x00,0x00,0x00,0x00,0x00,0x00,0x00,0x00,0x00,0x00,0x00,0x00,0x00,0x00,
0x00,0x00,0x00,0x00,0x00,0x00,0x00,0x00,0x00,0x00,0x00,0x00,0x00,0x00,0x00,0x00,
0x00,0x00,0x00,0x00,0x00,0x00,0x00,0x00,0x00,0x00,0x00,0x00,0x00,0x00,0x00,0x00,
0x00,0x00,0x00,0x00,0x00,0x00,0x00,0x00,0x00,0x00,0x00,0x00,0x00,0x00,0x00,0x00,
0x00,0x00,0x00,0x00,0x00,0x00,0x00,0x00,0x00,0x00,0x00,0x00,0x00,0x00,0x00,0x00,
0x00,0x00,0x00,0x00,0x00,0x00,0x00,0x00,0x00,0x00,0x00,0x00,0x00,0x00,0x00,0x00,
0x00,0x00,0x00,0x00,0x00,0x00,0x00,0x00,0x00,0x00,0x00,0x00,0x00,0x00,0x00,0x00,
0x00,0x00,0x00,0x00,0x00,0x00,0x00,0x00,0x00,0x00,0x00,0x00,0x00,0x00,0x00,0x00,
0x00,0x00,0x00,0x00,0x00,0x00,0x00,0x00,0x00,0x00,0x00,0x00,0x00,0x00,0x00,0x00,
0x00,0x00,0x00,0x00,0x00,0x00,0x00,0x00,0x00,0x00,0x00,0x00,0x00,0x00,0x00,0x00,
0x00,0x00,0x00,0x00,0x00,0x00,0x00,0x00,0x00,0x00,0x00,0x00,0x00,0x00,0x00,0x00,
0x00,0x00,0x00,0x00,0x00,0x00,0x00,0x00,0x00,0x00,0x00,0x00,0x00,0x00,0x00,0x00,
0x00,0x00,0x00,0x00,0x00,0x00,0x00,0x00,0x00,0x00,0x00,0x00,0x00,0x00,0x00,0x00,
0x00,0x00,0x00,0x00,0x00,0x00,0x00,0x00,0x00,0x00,0x00,0x00,0x00,0x00,0x00,0x00,
0x00,0x00,0x00,0x00,0x00,0x00,0x00,0x00,0x00,0x00,0x00,0x00,0x00,0x00,0x00,0x00,
0x00,0x00,0x00,0x00,0x00,0x00,0x00,0x00,0x00,0x00,0x00,0x00,0x00,0x00,0x00,0x00,
0x00,0x00,0x00,0x00,0x00,0x00,0x00,0x00,0x00,0x00,0x00,0x00,0x00,0x00,0x00,0x00,
0x00,0x00,0x00,0x00,0x00,0x00,0x00,0x00,0x00,0x00,0x00,0x00,0x00,0x00,0x00,0x00,
0x00,0x00,0x00,0x00,0x00,0x00,0x00,0x00,0x00,0x00,0x00,0x00,0x00,0x00,0x00,0x00,
0x00,0x00,0x00,0x00,0x00,0x00,0x00,0x00,0x00,0x00,0x00,0x00,0x00,0x00,0x00,0x00,
0x00,0x00,0x00,0x00,0x00,0x00,0x00,0x00,0x00,0x00,0x00,0x00,0x00,0x00,0x00,0x00,
0x00,0x00,0x00,0x00,0x00,0x00,0x00,0x00,0x00,0x00,0x00,0x00,0x00,0x00,0x00,0x00,
0x00,0x00,0x00,0x00,0x00,0x00,0x00,0x00,0x00,0x00,0x00,0x00,0x00,0x00,0x00,0x00,
0x00,0x00,0x00,0x00,0x00,0x00,0x00,0x00,0x00,0x00,0x00,0x00,0x00,0x00,0x00,0x00,
0x00,0x00,0x00,0x00,0x00,0x00,0x00,0x00,0x00,0x00,0x00,0x00,0x00,0x00,0x00,0x00,
0x00,0x00,0x00,0x00,0x00,0x00,0x00,0x00,0x00,0x00,0x00,0x00,0x00,0x00,0x00,0x00,
0x00,0x00,0x00,0x00,0x00,0x00,0x00,0x00,0x00,0x00,0x00,0x00,0x00,0x00,0x00,0x00,
0x00,0x00,0x00,0x00,0x00,0x00,0x00,0x00,0x00,0x00,0x00,0x00,0x00,0x00,0x00,0x00,
0x00,0x00,0x00,0x00,0x00,0x00,0x00,0x00,0x00,0x00,0x00,0x00,0x00,0x00,0x00,0x00,
0x00,0x00,0x00,0x00,0x00,0x00,0x00,0x00,0x00,0x00,0x00,0x00,0x00,0x00,0x00,0x00,
0x00,0x00,0x00,0x00,0x00,0x00,0x00,0x00,0x00,0x00,0x00,0x00,0x00,0x00,0x00,0x00,
0x00,0x00,0x00,0x00,0x00,0x00,0x00,0x00,0x00,0x00,0x00,0x00,0x00,0x00,0x00,0x00,
0x00,0x00,0x00,0x00,0x00,0x00,0x00,0x00,0x00,0x00,0x00,0x00,0x00,0x00,0x00,0x00,
0x00,0x00,0x00,0x00,0x00,0x00,0x00,0x00,0x00,0x00,0x00,0x00,0x00,0x00,0x00,0x00,
0x00,0x00,0x00,0x00,0x00,0x00,0x00,0x00,0x00,0x00,0x00,0x00,0x00,0x00,0x00,0x00,
0x00,0x00,0x00,0x00,0x00,0x00,0x00,0x00,0x00,0x00,0x00,0x00,0x00,0x00,0x00,0x00,
0x00,0x00,0x00,0x00,0x00,0x00,0x00,0x00,0x00,0x00,0x00,0x00,0x00,0x00,0x00,0x00,
0x00,0x00,0x00,0x00,0x00,0x00,0x00,0x00,0x00,0x00,0x00,0x00,0x00,0x00,0x00,0x00,
0x00,0x00,0x00,0x00,0x00,0x00,0x00,0x00,0x00,0x00,0x00,0x00,0x00,0x00,0x00,0x00,
0x00,0x00,0x00,0x00,0x00,0x00,0x00,0x00,0x00,0x00,0x00,0x00,0x00,0x00,0x00,0x00,
0x00,0x00,0x00,0x00,0x00,0x00,0x00,0x00,0x00,0x00,0x00,0x00,0x00,0x00,0x00,0x00,
0x00,0x00,0x00,0x00,0x00,0x00,0x00,0x00,0x00,0x00,0x00,0x00,0x00,0x00,0x00,0x00,
0x00,0x00,0x00,0x00,0x00,0x00,0x00,0x00,0x00,0x00,0x00,0x00,0x00,0x00,0x00,0x00,
0x00,0x00,0x00,0x00,0x00,0x00,0x00,0x00,0x00,0x00,0x00,0x00,0x00,0x00,0x00,0x00,
0x00,0x00,0x00,0x00,0x00,0x00,0x00,0x00,0x00,0x00,0x00,0x00,0x00,0x00,0x00,0x00,
0x00,0x00,0x00,0x00,0x00,0x00,0x00,0x00,0x00,0x00,0x00,0x00,0x00,0x00,0x00,0x00,
0x00,0x00,0x00,0x00,0x00,0x00,0x00,0x00,0x00,0x00,0x00,0x00,0x00,0x00,0x00,0x00,
0x00,0x00,0x00,0x00,0x00,0x00,0x00,0x00,0x00,0x00,0x00,0x00,0x00,0x00,0x00,0x00,
0x00,0x00,0x00,0x00,0x00,0x00,0x00,0x00,0x00,0x00,0x00,0x00,0x00,0x00,0x00,0x00,
0x00,0x00,0x00,0x00,0x00,0x00,0x00,0x00,0x00,0x00,0x00,0x00,0x00,0x00,0x00,0x00,
0x00,0x00,0x00,0x00,0x00,0x00,0x00,0x00,0x00,0x00,0x00,0x00,0x00,0x00,0x00,0x00,
0x00,0x00,0x00,0x00,0x00,0x00,0x00,0x00,0x00,0x00,0x00,0x00,0x00,0x00,0x00,0x00,
0x00,0x00,0x00,0x00,0x00,0x00,0x00,0x00,0x00,0x00,0x00,0x00,0x00,0x00,0x00,0x00,
0x00,0x00,0x00,0x00,0x00,0x00,0x00,0x00,0x00,0x00,0x00,0x00,0x00,0x00,0x00,0x00,
0x00,0x00,0x00,0x00,0x00,0x00,0x00,0x00,0x00,0x00,0x00,0x00,0x00,0x00,0x00,0x00,
0x00,0x00,0x00,0x00,0x00,0x00,0x00,0x00,0x00,0x00,0x00,0x00,0x00,0x00,0x00,0x00,
0x00,0x00,0x00,0x00,0x00,0x00,0x00,0x00,0x00,0x00,0x00,0x00,0x00,0x00,0x00,0x00,
0x00,0x00,0x00,0x00,0x00,0x00,0x00,0x00,0x00,0x00,0x00,0x00,0x00,0x00,0x00,0x00,
0x00,0x00,0x00,0x00,0x00,0x00,0x00,0x00,0x00,0x00,0x00,0x00,0x00,0x00,0x00,0x00,
0x00,0x00,0x00,0x00,0x00,0x00,0x00,0x00,0x00,0x00,0x00,0x00,0x00,0x00,0x00,0x00,
0x00,0x00,0x00,0x00,0x00,0x00,0x00,0x00,0x00,0x00,0x00,0x00,0x00,0x00,0x00,0x00,
0x00,0x00,0x00,0x00,0x00,0x00,0x00,0x00,0x00,0x00,0x00,0x00,0x00,0x00,0x00,0x00,
0x00,0x00,0x00,0x00,0x00,0x00,0x00,0x00,0x00,0x00,0x00,0x00,0x00,0x00,0x00,0x00,
0x00,0x00,0x00,0x00,0x38,0x38,0x38,0x00,0x4C,0x4C,0x4C,0x00,0xC6,0xC6,0xC6,0x00,
0xC6,0xC6,0xC6,0x00,0x64,0x64,0x64,0x00,0x38,0x38,0x38,0x00,0x00,0x00,0x00,0x00,
0x00,0x00,0x00,0x00,0x18,0x18,0x18,0x00,0x38,0x38,0x38,0x00,0x18,0x18,0x18,0x00,
0x18,0x18,0x18,0x00,0x18,0x18,0x18,0x00,0x7E,0x7E,0x7E,0x00,0x00,0x00,0x00,0x00,
0x00,0x00,0x00,0x00,0x7C,0x7C,0x7C,0x00,0xC6,0xC6,0xC6,0x00,0x0E,0x0E,0x0E,0x00,
0x7C,0x7C,0x7C,0x00,0xE0,0xE0,0xE0,0x00,0xFE,0xFE,0xFE,0x00,0x00,0x00,0x00,0x00,
0x00,0x00,0x00,0x00,0x7E,0x7E,0x7E,0x00,0x0C,0x0C,0x0C,0x00,0x38,0x38,0x38,0x00,
0x06,0x06,0x06,0x00,0xC6,0xC6,0xC6,0x00,0x7C,0x7C,0x7C,0x00,0x00,0x00,0x00,0x00,
0x00,0x00,0x00,0x00,0x1C,0x1C,0x1C,0x00,0x3C,0x3C,0x3C,0x00,0x6C,0x6C,0x6C,0x00,
0xCC,0xCC,0xCC,0x00,0xFE,0xFE,0xFE,0x00,0x0C,0x0C,0x0C,0x00,0x00,0x00,0x00,0x00,
0x00,0x00,0x00,0x00,0xFC,0xFC,0xFC,0x00,0x80,0x80,0x80,0x00,0xFC,0xFC,0xFC,0x00,
0x06,0x06,0x06,0x00,0xC6,0xC6,0xC6,0x00,0x7C,0x7C,0x7C,0x00,0x00,0x00,0x00,0x00,
0x00,0x00,0x00,0x00,0x7C,0x7C,0x7C,0x00,0xC0,0xC0,0xC0,0x00,0xFC,0xFC,0xFC,0x00,
0xC6,0xC6,0xC6,0x00,0xC6,0xC6,0xC6,0x00,0x7C,0x7C,0x7C,0x00,0x00,0x00,0x00,0x00,
0x00,0x00,0x00,0x00,0xFE,0xFE,0xFE,0x00,0xC6,0xC6,0xC6,0x00,0x0C,0x0C,0x0C,0x00,
0x18,0x18,0x18,0x00,0x30,0x30,0x30,0x00,0x30,0x30,0x30,0x00,0x00,0x00,0x00,0x00,
0x00,0x00,0x00,0x00,0x7C,0x7C,0x7C,0x00,0xC6,0xC6,0xC6,0x00,0x7C,0x7C,0x7C,0x00,
0xC6,0xC6,0xC6,0x00,0xC6,0xC6,0xC6,0x00,0x7C,0x7C,0x7C,0x00,0x00,0x00,0x00,0x00,
0x00,0x00,0x00,0x00,0x7C,0x7C,0x7C,0x00,0xC6,0xC6,0xC6,0x00,0xC6,0xC6,0xC6,0x00,
0x7E,0x7E,0x7E,0x00,0x06,0x06,0x06,0x00,0x7C,0x7C,0x7C,0x00,0x00,0x00,0x00,0x00,
0x00,0x00,0x00,0x00,0x00,0x00,0x00,0x00,0x00,0x00,0x00,0x00,0x00,0x10,0x00,0x00,
0x00,0x00,0x00,0x00,0x00,0x10,0x00,0x00,0x00,0x00,0x00,0x00,0x00,0x00,0x00,0x00,
0x00,0x00,0x00,0x00,0x00,0x00,0x00,0x00,0x00,0x00,0x00,0x00,0x00,0x10,0x00,0x00,
0x00,0x00,0x00,0x00,0x00,0x10,0x00,0x00,0x00,0x10,0x00,0x00,0x00,0x20,0x00,0x00,
0x08,0x08,0x08,0x00,0x18,0x18,0x18,0x00,0x3C,0x3C,0x3C,0x00,0x7C,0x7C,0x7C,0x00,
0x3C,0x3C,0x3C,0x00,0x18,0x18,0x18,0x00,0x08,0x08,0x08,0x00,0x00,0x00,0x00,0x00,
0x00,0x00,0x00,0x00,0x00,0x00,0x00,0x00,0x7C,0x7C,0x7C,0x00,0x00,0x00,0x00,0x00,
0x7C,0x7C,0x7C,0x00,0x00,0x00,0x00,0x00,0x00,0x00,0x00,0x00,0x00,0x00,0x00,0x00,
0x20,0x20,0x20,0x00,0x30,0x30,0x30,0x00,0x78,0x78,0x78,0x00,0x7C,0x7C,0x7C,0x00,
0x78,0x78,0x78,0x00,0x30,0x30,0x30,0x00,0x20,0x20,0x20,0x00,0x00,0x00,0x00,0x00,
0x38,0x38,0x38,0x00,0x44,0x44,0x44,0x00,0x08,0x08,0x08,0x00,0x10,0x10,0x10,0x00,
0x10,0x10,0x10,0x00,0x00,0x00,0x00,0x00,0x10,0x10,0x10,0x00,0x00,0x00,0x00,0x00,
0x00,0x3C,0x00,0x00,0x00,0x42,0x00,0x00,0x00,0x99,0x00,0x00,0x00,0xA1,0x00,0x00,
0x00,0xA1,0x00,0x00,0x00,0x99,0x00,0x00,0x00,0x42,0x00,0x00,0x00,0x3C,0x00,0x00,
0x00,0x10,0x00,0x00,0x00,0x28,0x00,0x00,0x00,0x44,0x00,0x00,0x00,0x44,0x00,0x00,
0x00,0x7C,0x00,0x00,0x00,0x44,0x00,0x00,0x00,0x44,0x00,0x00,0x00,0x00,0x00,0x00,
0x00,0x78,0x00,0x00,0x00,0x44,0x00,0x00,0x00,0x44,0x00,0x00,0x00,0x78,0x00,0x00,
0x00,0x44,0x00,0x00,0x00,0x44,0x00,0x00,0x00,0x78,0x00,0x00,0x00,0x00,0x00,0x00,
0x00,0x38,0x00,0x00,0x00,0x44,0x00,0x00,0x00,0x40,0x00,0x00,0x00,0x40,0x00,0x00,
0x00,0x40,0x00,0x00,0x00,0x44,0x00,0x00,0x00,0x38,0x00,0x00,0x00,0x00,0x00,0x00,
0x00,0x78,0x00,0x00,0x00,0x44,0x00,0x00,0x00,0x44,0x00,0x00,0x00,0x44,0x00,0x00,
0x00,0x44,0x00,0x00,0x00,0x44,0x00,0x00,0x00,0x78,0x00,0x00,0x00,0x00,0x00,0x00,
0x00,0x7C,0x00,0x00,0x00,0x40,0x00,0x00,0x00,0x40,0x00,0x00,0x00,0x78,0x00,0x00,
0x00,0x40,0x00,0x00,0x00,0x40,0x00,0x00,0x00,0x7C,0x00,0x00,0x00,0x00,0x00,0x00,
0x00,0x7C,0x00,0x00,0x00,0x40,0x00,0x00,0x00,0x40,0x00,0x00,0x00,0x78,0x00,0x00,
0x00,0x40,0x00,0x00,0x00,0x40,0x00,0x00,0x00,0x40,0x00,0x00,0x00,0x00,0x00,0x00,
0x00,0x3C,0x00,0x00,0x00,0x40,0x00,0x00,0x00,0x40,0x00,0x00,0x00,0x40,0x00,0x00,
0x00,0x4C,0x00,0x00,0x00,0x44,0x00,0x00,0x00,0x3C,0x00,0x00,0x00,0x00,0x00,0x00,
0x00,0x44,0x00,0x00,0x00,0x44,0x00,0x00,0x00,0x44,0x00,0x00,0x00,0x7C,0x00,0x00,
0x00,0x44,0x00,0x00,0x00,0x44,0x00,0x00,0x00,0x44,0x00,0x00,0x00,0x00,0x00,0x00,
0x00,0x38,0x00,0x00,0x00,0x10,0x00,0x00,0x00,0x10,0x00,0x00,0x00,0x10,0x00,0x00,
0x00,0x10,0x00,0x00,0x00,0x10,0x00,0x00,0x00,0x38,0x00,0x00,0x00,0x00,0x00,0x00,
0x00,0x04,0x00,0x00,0x00,0x04,0x00,0x00,0x00,0x04,0x00,0x00,0x00,0x04,0x00,0x00,
0x00,0x04,0x00,0x00,0x00,0x44,0x00,0x00,0x00,0x38,0x00,0x00,0x00,0x00,0x00,0x00,
0x00,0x44,0x00,0x00,0x00,0x48,0x00,0x00,0x00,0x50,0x00,0x00,0x00,0x60,0x00,0x00,
0x00,0x50,0x00,0x00,0x00,0x48,0x00,0x00,0x00,0x44,0x00,0x00,0x00,0x00,0x00,0x00,
0x00,0x40,0x00,0x00,0x00,0x40,0x00,0x00,0x00,0x40,0x00,0x00,0x00,0x40,0x00,0x00,
0x00,0x40,0x00,0x00,0x00,0x40,0x00,0x00,0x00,0x7C,0x00,0x00,0x00,0x00,0x00,0x00,
0x00,0x44,0x00,0x00,0x00,0x6C,0x00,0x00,0x00,0x54,0x00,0x00,0x00,0x54,0x00,0x00,
0x00,0x44,0x00,0x00,0x00,0x44,0x00,0x00,0x00,0x44,0x00,0x00,0x00,0x00,0x00,0x00,
0x00,0x44,0x00,0x00,0x00,0x44,0x00,0x00,0x00,0x64,0x00,0x00,0x00,0x54,0x00,0x00,
0x00,0x4C,0x00,0x00,0x00,0x44,0x00,0x00,0x00,0x44,0x00,0x00,0x00,0x00,0x00,0x00,
0x00,0x38,0x00,0x00,0x00,0x44,0x00,0x00,0x00,0x44,0x00,0x00,0x00,0x44,0x00,0x00,
0x00,0x44,0x00,0x00,0x00,0x44,0x00,0x00,0x00,0x38,0x00,0x00,0x00,0x00,0x00,0x00,
0x00,0x78,0x00,0x00,0x00,0x44,0x00,0x00,0x00,0x44,0x00,0x00,0x00,0x78,0x00,0x00,
0x00,0x40,0x00,0x00,0x00,0x40,0x00,0x00,0x00,0x40,0x00,0x00,0x00,0x00,0x00,0x00,
0x00,0x38,0x00,0x00,0x00,0x44,0x00,0x00,0x00,0x44,0x00,0x00,0x00,0x44,0x00,0x00,
0x00,0x54,0x00,0x00,0x00,0x48,0x00,0x00,0x00,0x34,0x00,0x00,0x00,0x00,0x00,0x00,
0x00,0x78,0x00,0x00,0x00,0x44,0x00,0x00,0x00,0x44,0x00,0x00,0x00,0x78,0x00,0x00,
0x00,0x50,0x00,0x00,0x00,0x48,0x00,0x00,0x00,0x44,0x00,0x00,0x00,0x00,0x00,0x00,
0x00,0x38,0x00,0x00,0x00,0x44,0x00,0x00,0x00,0x40,0x00,0x00,0x00,0x38,0x00,0x00,
0x00,0x04,0x00,0x00,0x00,0x44,0x00,0x00,0x00,0x38,0x00,0x00,0x00,0x00,0x00,0x00,
0x00,0x7C,0x00,0x00,0x00,0x10,0x00,0x00,0x00,0x10,0x00,0x00,0x00,0x10,0x00,0x00,
0x00,0x10,0x00,0x00,0x00,0x10,0x00,0x00,0x00,0x10,0x00,0x00,0x00,0x00,0x00,0x00,
0x00,0x44,0x00,0x00,0x00,0x44,0x00,0x00,0x00,0x44,0x00,0x00,0x00,0x44,0x00,0x00,
0x00,0x44,0x00,0x00,0x00,0x44,0x00,0x00,0x00,0x38,0x00,0x00,0x00,0x00,0x00,0x00,
0x00,0x44,0x00,0x00,0x00,0x44,0x00,0x00,0x00,0x44,0x00,0x00,0x00,0x44,0x00,0x00,
0x00,0x44,0x00,0x00,0x00,0x28,0x00,0x00,0x00,0x10,0x00,0x00,0x00,0x00,0x00,0x00,
0x00,0x44,0x00,0x00,0x00,0x44,0x00,0x00,0x00,0x44,0x00,0x00,0x00,0x54,0x00,0x00,
0x00,0x54,0x00,0x00,0x00,0x6C,0x00,0x00,0x00,0x44,0x00,0x00,0x00,0x00,0x00,0x00,
0x00,0x44,0x00,0x00,0x00,0x44,0x00,0x00,0x00,0x28,0x00,0x00,0x00,0x10,0x00,0x00,
0x00,0x28,0x00,0x00,0x00,0x44,0x00,0x00,0x00,0x44,0x00,0x00,0x00,0x00,0x00,0x00,
0x00,0x44,0x00,0x00,0x00,0x44,0x00,0x00,0x00,0x28,0x00,0x00,0x00,0x10,0x00,0x00,
0x00,0x10,0x00,0x00,0x00,0x10,0x00,0x00,0x00,0x10,0x00,0x00,0x00,0x00,0x00,0x00,
0x00,0x7C,0x00,0x00,0x00,0x04,0x00,0x00,0x00,0x08,0x00,0x00,0x00,0x10,0x00,0x00,
0x00,0x20,0x00,0x00,0x00,0x40,0x00,0x00,0x00,0x7C,0x00,0x00,0x00,0x00,0x00,0x00,
0x00,0x00,0x00,0x99,0x00,0x00,0x00,0x5A,0x00,0x00,0x00,0x24,0x00,0x00,0x00,0xC3,
0x00,0x00,0x00,0xC3,0x00,0x00,0x00,0x24,0x00,0x00,0x00,0x5A,0x00,0x00,0x00,0x99,
0x00,0x00,0x00,0x00,0x00,0x00,0x00,0x5A,0x00,0x00,0x00,0x24,0x00,0x00,0x00,0x42,
0x00,0x00,0x00,0x42,0x00,0x00,0x00,0x24,0x00,0x00,0x00,0x5A,0x00,0x00,0x00,0x00,
0x00,0x00,0x00,0x00,0x00,0x00,0x00,0x00,0x00,0x00,0x00,0x18,0x00,0x00,0x00,0x24,
0x00,0x00,0x00,0x24,0x00,0x00,0x00,0x18,0x00,0x00,0x00,0x00,0x00,0x00,0x00,0x00,
0x00,0x00,0x00,0x00,0x00,0x00,0x00,0x00,0x00,0x00,0x00,0x00,0x00,0x00,0x00,0x18,
0x00,0x00,0x00,0x18,0x00,0x00,0x00,0x00,0x00,0x00,0x00,0x00,0x00,0x00,0x00,0x00,
0x00,0x00,0x00,0x00,0x00,0x00,0x00,0x00,0x00,0x00,0x00,0x00,0x00,0x00,0x00,0x00,
0x00,0x00,0x00,0x00,0x00,0x00,0x00,0x00,0x00,0xFF,0x00,0x00,0x00,0x00,0x00,0x00,
0x00,0x00,0x00,0x00,0x00,0x20,0x00,0x00,0x00,0x20,0x00,0x00,0x00,0x10,0x00,0x00,
0x00,0x00,0x00,0x00,0x00,0x00,0x00,0x00,0x00,0x00,0x00,0x00,0x00,0x00,0x00,0x00,
0x00,0x00,0x00,0x00,0x00,0x00,0x00,0x00,0x00,0x00,0x00,0x00,0x00,0x34,0x00,0x00,
0x00,0x4C,0x00,0x00,0x00,0x44,0x00,0x00,0x00,0x4C,0x00,0x00,0x00,0x34,0x00,0x00,
0x00,0x00,0x00,0x00,0x00,0x40,0x00,0x00,0x00,0x40,0x00,0x00,0x00,0x58,0x00,0x00,
0x00,0x64,0x00,0x00,0x00,0x44,0x00,0x00,0x00,0x64,0x00,0x00,0x00,0x58,0x00,0x00,
0x00,0x00,0x00,0x00,0x00,0x00,0x00,0x00,0x00,0x00,0x00,0x00,0x00,0x1C,0x00,0x00,
0x00,0x20,0x00,0x00,0x00,0x20,0x00,0x00,0x00,0x20,0x00,0x00,0x00,0x1C,0x00,0x00,
0x00,0x00,0x00,0x00,0x00,0x04,0x00,0x00,0x00,0x04,0x00,0x00,0x00,0x34,0x00,0x00,
0x00,0x4C,0x00,0x00,0x00,0x44,0x00,0x00,0x00,0x4C,0x00,0x00,0x00,0x34,0x00,0x00,
0x00,0x00,0x00,0x00,0x00,0x00,0x00,0x00,0x00,0x00,0x00,0x00,0x00,0x38,0x00,0x00,
0x00,0x44,0x00,0x00,0x00,0x7C,0x00,0x00,0x00,0x40,0x00,0x00,0x00,0x38,0x00,0x00,
0x00,0x00,0x00,0x00,0x00,0x0C,0x00,0x00,0x00,0x10,0x00,0x00,0x00,0x10,0x00,0x00,
0x00,0x38,0x00,0x00,0x00,0x10,0x00,0x00,0x00,0x10,0x00,0x00,0x00,0x10,0x00,0x00,
0x00,0x00,0x00,0x00,0x00,0x00,0x00,0x00,0x00,0x34,0x00,0x00,0x00,0x4C,0x00,0x00,
0x00,0x44,0x00,0x00,0x00,0x3C,0x00,0x00,0x00,0x04,0x00,0x00,0x00,0x38,0x00,0x00,
0x00,0x00,0x00,0x00,0x00,0x40,0x00,0x00,0x00,0x40,0x00,0x00,0x00,0x78,0x00,0x00,
0x00,0x44,0x00,0x00,0x00,0x44,0x00,0x00,0x00,0x44,0x00,0x00,0x00,0x44,0x00,0x00,
0x00,0x00,0x00,0x00,0x00,0x10,0x00,0x00,0x00,0x00,0x00,0x00,0x00,0x30,0x00,0x00,
0x00,0x10,0x00,0x00,0x00,0x10,0x00,0x00,0x00,0x10,0x00,0x00,0x00,0x38,0x00,0x00,
0x00,0x00,0x00,0x00,0x00,0x08,0x00,0x00,0x00,0x00,0x00,0x00,0x00,0x08,0x00,0x00,
0x00,0x08,0x00,0x00,0x00,0x08,0x00,0x00,0x00,0x08,0x00,0x00,0x00,0x30,0x00,0x00,
0x00,0x00,0x00,0x00,0x00,0x40,0x00,0x00,0x00,0x40,0x00,0x00,0x00,0x48,0x00,0x00,
0x00,0x50,0x00,0x00,0x00,0x70,0x00,0x00,0x00,0x48,0x00,0x00,0x00,0x44,0x00,0x00,
0x00,0x00,0x00,0x00,0x00,0x30,0x00,0x00,0x00,0x10,0x00,0x00,0x00,0x10,0x00,0x00,
0x00,0x10,0x00,0x00,0x00,0x10,0x00,0x00,0x00,0x10,0x00,0x00,0x00,0x38,0x00,0x00,
0x00,0x00,0x00,0x00,0x00,0x00,0x00,0x00,0x00,0x00,0x00,0x00,0x00,0x6C,0x00,0x00,
0x00,0x52,0x00,0x00,0x00,0x52,0x00,0x00,0x00,0x52,0x00,0x00,0x00,0x52,0x00,0x00,
0x00,0x00,0x00,0x00,0x00,0x00,0x00,0x00,0x00,0x00,0x00,0x00,0x00,0x78,0x00,0x00,
0x00,0x44,0x00,0x00,0x00,0x44,0x00,0x00,0x00,0x44,0x00,0x00,0x00,0x44,0x00,0x00,
0x00,0x00,0x00,0x00,0x00,0x00,0x00,0x00,0x00,0x00,0x00,0x00,0x00,0x38,0x00,0x00,
0x00,0x44,0x00,0x00,0x00,0x44,0x00,0x00,0x00,0x44,0x00,0x00,0x00,0x38,0x00,0x00,
0x00,0x00,0x00,0x00,0x00,0x00,0x00,0x00,0x00,0x00,0x00,0x00,0x00,0x70,0x00,0x00,
0x00,0x48,0x00,0x00,0x00,0x48,0x00,0x00,0x00,0x70,0x00,0x00,0x00,0x40,0x00,0x00,
0x00,0x00,0x00,0x00,0x00,0x00,0x00,0x00,0x00,0x00,0x00,0x00,0x00,0x1C,0x00,0x00,
0x00,0x24,0x00,0x00,0x00,0x24,0x00,0x00,0x00,0x1C,0x00,0x00,0x00,0x06,0x00,0x00,
0x00,0x00,0x00,0x00,0x00,0x00,0x00,0x00,0x00,0x00,0x00,0x00,0x00,0x58,0x00,0x00,
0x00,0x60,0x00,0x00,0x00,0x40,0x00,0x00,0x00,0x40,0x00,0x00,0x00,0x40,0x00,0x00,
0x00,0x00,0x00,0x00,0x00,0x00,0x00,0x00,0x00,0x00,0x00,0x00,0x00,0x3C,0x00,0x00,
0x00,0x40,0x00,0x00,0x00,0x38,0x00,0x00,0x00,0x04,0x00,0x00,0x00,0x78,0x00,0x00,
0x00,0x00,0x00,0x00,0x00,0x10,0x00,0x00,0x00,0x10,0x00,0x00,0x00,0x7C,0x00,0x00,
0x00,0x10,0x00,0x00,0x00,0x10,0x00,0x00,0x00,0x10,0x00,0x00,0x00,0x10,0x00,0x00,
0x00,0x00,0x00,0x00,0x00,0x00,0x00,0x00,0x00,0x00,0x00,0x00,0x00,0x44,0x00,0x00,
0x00,0x44,0x00,0x00,0x00,0x44,0x00,0x00,0x00,0x44,0x00,0x00,0x00,0x3C,0x00,0x00,
0x00,0x00,0x00,0x00,0x00,0x00,0x00,0x00,0x00,0x00,0x00,0x00,0x00,0x44,0x00,0x00,
0x00,0x44,0x00,0x00,0x00,0x28,0x00,0x00,0x00,0x28,0x00,0x00,0x00,0x10,0x00,0x00,
0x00,0x00,0x00,0x00,0x00,0x00,0x00,0x00,0x00,0x00,0x00,0x00,0x00,0x52,0x00,0x00,
0x00,0x52,0x00,0x00,0x00,0x52,0x00,0x00,0x00,0x52,0x00,0x00,0x00,0x2C,0x00,0x00,
0x00,0x00,0x00,0x00,0x00,0x00,0x00,0x00,0x00,0x00,0x00,0x00,0x00,0x44,0x00,0x00,
0x00,0x28,0x00,0x00,0x00,0x10,0x00,0x00,0x00,0x28,0x00,0x00,0x00,0x44,0x00,0x00,
0x00,0x00,0x00,0x00,0x00,0x00,0x00,0x00,0x00,0x00,0x00,0x00,0x00,0x24,0x00,0x00,
0x00,0x24,0x00,0x00,0x00,0x3C,0x00,0x00,0x00,0x04,0x00,0x00,0x00,0x38,0x00,0x00,
0x00,0x00,0x00,0x00,0x00,0x00,0x00,0x00,0x00,0x00,0x00,0x00,0x00,0x7C,0x00,0x00,
0x00,0x08,0x00,0x00,0x00,0x10,0x00,0x00,0x00,0x20,0x00,0x00,0x00,0x7C,0x00,0x00,
0x00,0x00,0x00,0x00,0x00,0x0C,0x00,0x00,0x00,0x10,0x00,0x00,0x00,0x10,0x00,0x00,
0x00,0x20,0x00,0x00,0x00,0x10,0x00,0x00,0x00,0x10,0x00,0x00,0x00,0x0C,0x00,0x00,
0x00,0x00,0x00,0x00,0x00,0x10,0x00,0x00,0x00,0x10,0x00,0x00,0x00,0x10,0x00,0x00,
0x00,0x00,0x00,0x00,0x00,0x10,0x00,0x00,0x00,0x10,0x00,0x00,0x00,0x10,0x00,0x00,
0x00,0x00,0x00,0x00,0x00,0x60,0x00,0x00,0x00,0x10,0x00,0x00,0x00,0x10,0x00,0x00,
0x00,0x08,0x00,0x00,0x00,0x10,0x00,0x00,0x00,0x10,0x00,0x00,0x00,0x60,0x00,0x00,
0x00,0x00,0x00,0xFF,0x00,0x00,0x00,0xFF,0x00,0x00,0x00,0xFF,0x00,0x00,0x00,0xFF,
0x00,0x00,0x00,0xFF,0x00,0x00,0x00,0xFF,0x00,0x00,0x00,0xFF,0x00,0x00,0x00,0xFF,
0x00,0xFF,0x00,0x00,0x00,0xFF,0x00,0x00,0x00,0xFF,0x00,0x00,0x00,0xFF,0x00,0x00,
0x00,0xFF,0x00,0x00,0x00,0xFF,0x00,0x00,0x00,0xFF,0x00,0x00,0x00,0xFF,0x00,0x00,